11111111111111111111111111111111111111111
10000000100000001000000000000000001000001
11111110101111101010111111101111101011101
10000010001010001010000000101000100010101
10101011111010111111111110101010111110101
10101000000010100000001000101010000010001
10101111101110101011101011111011111011111
10100010101000101010001000000000001000001
11111010101011101010111011111111111011101
10000010001000101010001010001000001010001
10111110111110101011101110101011101010101
10100000100000101000100000100010001010101
10101111101111101110101111111110111110101
10100000100010101000101000100010100000101
10111111111010101011111010101110101111101
10100010001010001000000010100010001000101
10101010101011111111111110111011111110101
10001000101010000010000010001000000000101
10111111101010111010111010101010101111101
10001000101000101010100010101010101000001
11111010101111101010101111101110111011111
10000010001000001000100000100010000010001
10111111111011101111111110111010111111101
10100000100010100000000010100010001000001
10101110101110111111101110101111101110111
10000010101000000000100000101000100010001
11111110101111111010111111101110111010101
10000000100000000010100000001000001010101
10111110111111111110101111111011101011101
10001010100000000010001000001000101000001
10101010111110111011111110101110111111101
10101010000000101000000000100000100000001
11101011111111101111101111111111101111111
10001000000000000000001000000000001000001
10111011111111111111111011111111111011101
10100000100010000000000010000010000010101
10111111101010111111111111101010111110101
10000010001010100000001000001000100000001
10111010111010111011101011111111101111111
10001000001000000010000010000000000000001
11111111111111111111111111111111111111111
