11111111111111111111111111111111111111111
10001000101000000010000000001000000010001
11101010101010111010111111101110111011101
10001010001010001000100000100010100010001
10111011111011101111101111111010101110101
10100000001000101010000000000010100000101
10101111101011101010111111111110111111101
10101000100010001010001000000000100010001
10101010111110111011101110111111111010111
10101010000010100000100000100010000010101
10111011111010101010111111101110101010101
10001010001000101010001000000000101010101
11101010111111111011101011111111101010101
10100010001000000010101010000000101010001
10111110101010111110101110111110101111101
10000010101010001000100000101000100010001
10111010101011101011111111101011111010111
10001000101000101000000000001000001010101
11101111101011101011111111101111101010101
10001000101010001000100000100000000010101
10111010101010111110111011111111101110101
10100010100010100010001000001000101000101
10111010111110101111101110101010111011101
10100010100010100000100010101010001000101
10101011101010101110111010111011101110101
10101010001000101010100000100010001000101
10101010101111101010101111101110111011101
10001010101000100010001000001010100010001
11111110111010111011111011111010101110111
10000000100010001010001000001010100010001
10111110101111101110101111101010111011101
10001000100000100000100010000010001000101
10101110111011111111101110111110101110101
10100010100010001000001000101000101000101
11111010101110101011111011101011101011101
10000010101000100010001010001010001000101
10101111101011111110101010101011101110101
10101000101000001000100010101000100010101
10111010101111101011111111101110111110101
10000010000000100000000000000010000000001
11111111111111111111111111111111111111111
